1111111111111
1E000000E0001
1000P00000011
100011100E001
1000111000011
10E0111000011
100C0000
1111111111111