1111111111111
1C000000C0001
1000P00000011
100011100E001
1000111000011
10C0111000011
100C000000001
1111111111111