1111111111
10000C00P1
1CE000P001
1111111111