1111111111
100E0C001
1C0000P001
1111111111